10 . o B
oo.o.o....o....ooooo
.o..o....o...oo....o
...o..o.o.o..o.ooo.o
o.o....o..........oo
o..............o...o
...o....o...o.o...oo
...........o.....o.o
.o...o..o.o....oo...
....oo......o..o....
...o......o.....o...
